0 0 0 0 0 4 0 0 0 0 4 4 4 4 4 4 4 4 0 0 0 0 0 0 0 0 0 0 0 0 
0 4 0 0 0 0 0 0 0 0 4 0 0 0 5 0 0 4 0 0 0 4 0 0 0 5 5 4 0 0 
0 0 0 0 0 0 0 0 0 0 4 4 4 4 4 4 4 4 0 0 0 0 0 0 1 5 5 4 0 0 
0 4 1 1 1 1 1 1 1 1 1 0 0 1 0 0 0 0 0 0 0 0 0 0 1 4 4 4 0 0 
0 5 0 0 4 0 0 0 0 4 0 0 0 1 220 0 4 4 4 4 4 0 0 0 1 0 0 4 4 4 
0 4 0 0 0 0 0 4 0 0 0 0 0 1 0 0 4 4 4 4 4 0 0 0 1 0 0 4 4 4 
0 4 0 4 0 4 1 0 0 0 0 0 0 1 4 0 0 0 0 1 1 1 1 1 1 1 1 1 1 0 
0 4 0 0 0 0 1 1 1 4 1 0 0 1 0 0 0 4 0 0 0 0 0 0 0 0 0 0 0 0 
0 5 0 0 1 0 1 230 1 4 1 0 0 1 0 0 0 0 4 0 0 0 0 0 0 0 0 0 0 100 
0 0 4 0 1 0 1 0 1 4 1 4 0 1 0 0 5 0 0 1 0 0 0 0 4 0 0 0 0 0 
4 0 0 0 1 0 1 0 1 1 1 4 0 1 0 4 0 0 0 1 0 0 4 0 0 0 0 0 0 0 
0 0 0 0 1 0 1 0 1 0 0 0 0 0 0 0 0 4 0 1 0 4 0 0 0 4 0 4 0 0 
0 0 0 0 1 0 1 0 1 0 0 0 0 0 0 0 1 1 1 1 1 1 1 0 0 0 0 0 0 0 
0 0 0 0 1 0 1 0 1 0 4 5 0 4 0 3 0 4 0 1 0 0 4 0 5 0 0 0 0 0 
0 0 4 0 1 0 0 0 1 0 0 0 0 0 0 0 0 0 0 1 0 0 4 0 4 0 0 4 0 0 
0 0 0 0 1 0 1 0 1 0 0 0 0 0 4 5 0 0 0 1 0 0 0 0 0 4 0 4 0 0 
0 0 4 0 0 1 1 1 1 0 0 0 0 0 200 110 0 4 4 4 4 4 0 0 0 0 0 0 0 0 
4 0 0 0 0 1 0 0 0 0 0 0 4 0 0 0 0 0 4 4 4 4 4 0 0 0 0 0 0 0 
0 0 4 0 4 1 0 0 0 4 0 0 0 0 0 0 0 0 0 0 0 0 0 0 0 0 0 4 4 4 
4 0 0 0 0 1 0 4 0 0 0 0 0 0 0 0 0 0 0 0 0 0 0 0 0 0 0 0 0 0 
0 0 4 0 0 1 0 0 4 0 0 0 4 0 0 4 0 1 1 1 1 1 1 1 1 1 0 0 0 0 
0 0 0 4 0 1 0 0 0 0 0 0 0 0 0 0 0 0 0 0 0 1 4 0 0 0 0 0 0 0 
0 0 4 0 0 1 4 0 0 0 210 0 0 0 0 0 0 4 0 0 0 1 4 0 0 0 0 0 0 0 
0 0 0 0 4 1 1 1 1 1 1 1 1 1 1 0 0 0 0 0 0 1 4 0 0 0 0 0 0 0 
4 0 0 0 0 0 0 0 0 0 0 4 4 4 1 0 0 0 4 0 0 1 4 0 0 4 0 4 0 0 
0 0 4 0 4 0 0 4 0 0 0 4 5 4 1 0 0 0 0 0 0 1 4 0 0 0 5 0 0 0
0 0 0 0 0 0 0 0 0 0 0 4 4 4 1 0 0 0 4 0 0 1 4 0 0 0 0 0 0 0 
0 4 0 0 0 1 1 1 1 1 1 1 1 1 1 0 0 0 0 0 0 0 0 0 0 4 0 4 0 0 
0 0 0 0 4 0 0 0 0 0 0 4 4 4 0 0 0 0 0 0 0 0 4 0 0 0 0 0 0 0 
0 0 0 0 0 0 0 4 0 0 0 4 4 4 4 4 4 4 4 0 0 0 0 0 4 0 0 0 0 4 
